XXXXXXXXXXXXXXXX
OOOXXXXXXXXXXXXX
XXOXXXXXXXXXXXXX
XXOOOOOOOOOOOOXX
XXXXXXXXXXXXXOXX
XXXXXXXXXXXXXOXX
XXXXXXXXXXXXXOOO
XXXXXXXXXXXXXXXX
XXXXXXXXXXXXXXXX