. . S . . . . . . . . . . E . .
. . X . . . . . . . . . X X . .
. . X X . . . . . . . X X . . .
. . . X X . . . . . X X . . . .
. . . . X X . . . X X . . . . .
. . . . . X X . X X . . . . . .
. . . . . . X X X . . . . . . .
. . . . . . . . . . . . . . . .
. . . . . . . . . . . . . . . .